R 200 200

 SO /home/bwayfare/C_Project/cub3D/test.xpm
         NO              /home/bwayfare/C_Project/cub3D/test.xpm


WE /home/bwayfare/C_Project/cub3D/test.xpm
EA /home/bwayfare/C_Project/cub3D/test.xpm
S /home/bwayfare/C_Project/cub3D/test.xpm

F 200, 125, 168

 C 254, 125, 168

111111
1N1111
111111

11111111111111
10000000000001
11111111111111