R 200 200
SO /home/bwayfare/C_Project/cub3D/test.xpm
NO /home/bwayfare/C_Project/cub3D/test.xpm
WE /home/bwayfare/C_Project/cub3D/test.xpm
EA /home/bwayfare/C_Project/cub3D/test.xpm
S /home/bwayfare/C_Project/cub3D/test.xpm

F 200, 125, 168

 C 254, 125, 168


11111111111
   12221001
14111111111

1111
1001
1111