R 200 200

 SO /home/bwayfare/C_Project/cub3D/test.xpm
         NO              /home/bwayfare/C_Project/cub3D/test.xpm


WE /home/bwayfare/C_Project/cub3D/test.xpm
EA /home/bwayfare/C_Project/cub3D/test.xpm
S /home/bwayfare/C_Project/cub3D/test.xpm

F 200, 125, 166

C 254, 125, 168
111111111111
1000100N2001
100020202021
120010001111
111111111111

11111111
10020211
10200001
11111111