R 200 100

 SO /home/bwayfare/C_Project/cub3D/test.xpm
         NO              /home/bwayfare/C_Project/cub3D/test.xpm


WE /home/bwayfare/C_Project/cub3D/test.xpm
EA /home/bwayfare/C_Project/cub3D/test.xpm
S /home/bwayfare/C_Project/cub3D/test.xpm

F 200, 125, 168

C 254, 125, 168
111111111111
1000000N2001
100020202021
120010001111
111111111111