SO /home/bwayfare/C_Project/cub3D/test.xpm
NO /home/bwayfare/C_Project/cub3D/test.xpm
WE /home/bwayfare/C_Project/cub3D/test.xpm
EA /home/bwayfare/C_Project/cub3D/test.xpm
S /home/bwayfare/C_Project/cub3D/test.xpm

F 200, 125, 168

 C 254, 125, 168

R 200 200

11111111
  10000N2
12221001111
11111111

11l111101111
