R 700 600

 SO /home/bwayfare/C_Project/cub3D/textures/te.xpm
 NO /home/bwayfare/C_Project/cub3D/textures/tex1.xpm


 WE /home/bwayfare/C_Project/cub3D/textures/tex2.xpm
 EA /home/bwayfare/C_Project/cub3D/textures/tex3.xpm
 S /home/bwayfare/C_Project/cub3D/textures/tex4.xpm

C 133, 160, 254

F 20, 70, 160

1111111111111111111111111111
1000000000000000000000000001
1000000000000000000000000001
1000000000000000000000000001
1000000000000000000000000001
1000000000000000000000000001
10000000000000000000000000011111111111111111111111111111111111111
10000000000000000000000000020000000000000000000000000000000000001
10000000000000000000000000000100000000000000000000000000000000001
10000000000000000000000000020000000000000000000000000000000000001
10000000000000000000000000011111111111111111111111111111111100001
1000000000000000000000000001                               100001
1000000000000000000000000001                               100001
1000000000000000000000000001                               100001
1000000000000000000000000001                               111111
1000000000000000000000000001
1000000000000000000000000001
1000000000000000000000000001
1000000000000000000000000001
1000000000000000000000N00001
1000000000000000000000000001
1111111111111111111111111111