R 1 21474830000

 SO /Users/bwayfare/Learn/cub3d/test.xpm
 NO /Users/bwayfare/Learn/cub3d/test.xpm


 WE /Users/bwayfare/Learn/cub3d/test.xpm
 EA /Users/bwayfare/Learn/cub3d/test.xpm
 S /Users/bwayfare/Learn/cub3d/test.xpm

F 254, 123, 254

C 52, 254, 252



111111111111
100010002001
1000202N2021
120010201111
111111111111

11111111
10020211
10200001
11111111