R 1 214748367

 SO /home/bwayfare/C_Project/cub3D/textures/te1.xpm
 NO /home/bwayfare/C_Project/cub3D/textures/te2.xpm


 WE /home/bwayfare/C_Project/cub3D/textures/te3.xpm
 EA /home/bwayfare/C_Project/cub3D/textures/te.xpm
 S /home/bwayfare/C_Project/cub3D/textures/barrel.xpm

F 254, 123, 254

C 52, 254, 253

111111111111
1000100N2001
100020202021
120010001111
111111111111

11111111
10020211
10200001
11111111