R 500 500

 SO /home/bwayfare/C_Project/cub3D/textures/te.xpm
 NO /home/bwayfare/C_Project/cub3D/textures/tex1.xpm


 WE /home/bwayfare/C_Project/cub3D/textures/tex2.xpm
 EA /home/bwayfare/C_Project/cub3D/textures/tex3.xpm
 S /home/bwayfare/C_Project/cub3D/textures/tex4.xpm

F 254, 123, 254

C 52, 254, 253

111111111111
100010002001
100N20202021
120010001111
111111111111