R 500 500

 SO /home/bwayfare/C_Project/cub3D/textures/te.xpm
 NO /home/bwayfare/C_Project/cub3D/textures/tex1.xpm


 WE /home/bwayfare/C_Project/cub3D/textures/tex2.xpm
 EA /home/bwayfare/C_Project/cub3D/textures/tex3.xpm
 S /home/bwayfare/C_Project/cub3D/textures/tex4.xpm

F 122, 200, 25

C 122, 200, 25

1111111111111111111111111111
1000000000000000000000000001
1000000000000000000000000001
1000000000000000000000000001
1000000000000000000000000001
1000000000000000000000000001
1000000000000000000N00000001
1000000000000000000000000001
1000000000000000000000000001
1000000000000000000000000001
1000000000000000000000000001
1000000000000000000000000001
1000000000000000000000000001
1000000000000000000000000001
1000000000000000000000000001
1000000000000000000000000001
1000000000000000000000000001
1000000000000000000000000001
1000000000000000000000000001
1000000000000000000000000001
1000000000000000000000000001
1111111111111111111111111111