11111111
10000N21
12221001
11111111