R 800 600

 SO /Users/bwayfare/Learn/cub3d/textures/bluestone.xpm
 NO /Users/bwayfare/Learn/cub3d/textures/greystone.xpm


 WE /Users/bwayfare/Learn/cub3d/textures/purplestone.xpm
 EA /Users/bwayfare/Learn/cub3d/textures/redbrick.xpm
 S /Users/bwayfare/Learn/cub3d/textures/barrel.xpm

C 133, 160, 254

F 20, 70, 160

1111111111111111111111111111
1000000000000000000000000001
1000000000000000000000000001
1000100010000000000100000001
1000000000000000000000000001
1010001000010001000100000001
10000000000000000000000000011111111111111111111111111111111111111
10100000000100000000000000020000000000000000000000000000000000001
10000010000000001000000000000100000000000000000000000000000000001
10100000001000000000000000020000000000000000000000000000000000001
10000000000000000000000000011111111111111111111111111111111100001
1000000000000000000000000001                               100001
1000000000000000000000000001                               100001
1000000000000000000000000001                               100001
1000000000000000000000000001                               111111
1000000000000000000000000001
1000000000000000000000000001
1000000000000000000000000001
1000000000000000000000000001
1000000000000000000000N00001
1000000000000000000000000001
1111111111111111111111111111