R 1000 1000

SO /Users/bwayfare/Learn/cub3d/textures/mossy.xpm
NO /Users/bwayfare/Learn/cub3d/textures/colorstone.xpm


WE /Users/bwayfare/Learn/cub3d/textures/purplestone.xpm
EA /Users/bwayfare/Learn/cub3d/textures/redbrick.xpm
S /Users/bwayfare/Learn/cub3d/textures/barrel.xpm

C 133, 22, 254

F 20, 70, 160

1111111111111111111111111111
1000000000000000000000000001
1000000000000000000000000001
1000100010000000000100000001
1000000000000000000000000001
1010001000010001000100000001
10000000000000000000000000011111111111111111111111111111111111111
10100000000100000000000000020000000000000000000000000000000000001
10000010000000001000000000000100000000000000000000000000000000001
10100000N02000000000000000020000000000000000000000000000000000001
10000000000000000000000000011111111111111111111111111111111100001
1000000000000000000000000001                               100001
1000000020000000000000000001                               100001
1000000000000000000000000001                               100001
1000000020000000000000000001                               111111
1000000000000000000000000001
1000000020000000001000001001
1000000000000000000000000001
1000000000000000100000100001
1000000020000000000000002001
1000000000000000000000000001
1111111111111111111111111111
